20
15
0 0 0 0 0 0 0 0 0 0 0 0 0 0 0 0 0 0 0 0 
0 0 0 0 0 0 0 0 0 0 0 0 0 0 0 0 0 0 0 0 
0 0 0 0 0 0 0 0 0 0 0 0 0 0 0 0 0 0 0 0 
0 0 0 0 0 0 0 0 0 0 0 0 0 0 0 0 0 0 0 0 
0 0 0 0 0 0 0 0 0 0 0 0 0 0 0 0 0 0 0 0 
0 0 0 0 0 0 0 0 0 0 0 0 0 0 0 0 0 0 0 0 
0 12 12 12 12 12 0 12 12 12 0 12 12 12 12 12 0 12 12 12 
0 12 0 12 0 12 0 12 0 0 0 12 0 12 0 12 0 12 0 0 
0 12 0 0 0 12 0 12 12 0 0 12 0 0 0 12 0 12 12 0 
0 12 0 0 0 12 0 12 0 0 0 12 0 0 0 12 0 12 0 0 
0 12 0 0 0 12 0 12 12 12 0 12 0 0 0 12 0 12 12 12 
0 0 0 0 0 0 0 0 0 0 0 0 0 0 0 0 0 0 0 0 
0 0 0 0 0 0 0 0 0 0 0 0 0 0 0 0 0 0 0 0 
23 24 24 24 24 24 24 24 24 24 24 24 24 24 24 24 24 24 24 25 
0 0 0 0 0 0 0 0 0 0 0 0 0 0 0 0 0 0 0 0 
