11
8
22 22 22 22 22 22 22 22 22 22 22 
22 4 0 0 0 0 0 0 0 3 22 
22 4 0 0 0 0 0 0 0 3 22 
22 4 0 0 0 0 0 0 0 3 22 
22 4 23 25 0 0 0 23 25 3 22 
22 4 0 0 0 0 0 0 0 3 22 
22 4 9 0 10 0 0 0 0 3 22 
5 21 21 21 21 21 21 21 21 21 22 
